いかが|いかが
ケーキ|けーき|cake
出す|だす
クラス|くらす
所が|ところが
先生|せんせい
御宅|おたく
奥さん|おくさん
吃驚|びっくり
朝|あさ
杯|はい
何|なに
冷たい|つめたい
実は|じつは
今朝|けさ
コーラ|こーら
丁寧|ていねい
答える|こたえる
持つ|もつ
変|へん
考える|かんがえる
帰る|かえる
話|はなし
次|つぎ
仰る|おっしゃる
文字通り|もじどおり
選べる|えらべる
聞こえる|きこえる
けれど
文|ぶん
飲|いん
みたい
意味|いみ
這う|はう
じゃあ|じゃあ
頂く|いただく
結構|けっこう
喉|のど
散らかす|ちらかす
叶う|かなう
それなのに|それなのに
思う|おもう
どうして
ようやく|ようやく