全然|ぜんぜん
高い|たかい
学費|がくひ
払う|はらう
もったいない
為|ため
確か|たしか
比べる|くらべる
量|りょう
多分|たぶん
長い|ながい
人生|じんせい
唯一|ゆいいつ
休息|きゅうそく
時期|じき
会社|かいしゃ
いけない
高校|こうこう
強制|きょうせい
まで
特に|とくに
生|せい
日|にち
珍しい|めずらしい
卒業|そつぎょう
今度|こんど
早くから
遅い|おそい
働く|はたらく
家族|かぞく
犠牲|ぎせい
普通|ふつう
くらい
休む|やすむ
取れる|とれる
はず
同僚|どうりょう
迷惑|めいわく
掛ける|かける
しまう
実際|じっさい
定年|ていねん
辞める|やめる
一生懸命|いっしょうけんめい
仕事|しごと
このように
見る|みる
年間|ねんかん
ゆっくり
出来る|できる
受験|じゅけん
中心|ちゅうしん
馬車|ばしゃ
馬|うま
似る|にる
アルバイト
金|かね
作る|つくる
サークル
活動|かつどう
クラブ
積極|せっきょく
的だ|てきだ
参加|さんか
友達|ともだち
コンパ
パーティー
出る|でる
酒|さけ
デート
楽しむ|たのしむ
見える|みえる
しかし
大いに|おおいに
経済|けいざい
大国|たいこく
エネルギー
蓄積|ちくせき
