集団|しゅうだん
個人|こじん
行動|こうどう
近く|ちかく
社員|しゃいん
駐車|ちゅうしゃ
場|じょう
一緒|いっしょ
ラジオ
音楽|おんがく
ながら
体操|たいそう
昼|ひる
マグドナルド
色|いろ
着る|きる
制服|せいふく
夕方|ゆうがた
テニス
部|ぶ
飲み屋|のみや
けど
父さん|とうさん
サラリーマン
後|あと
週|しゅう
末|まつ
コート
土曜日|どようび
ゴルフ
例えば|たとえば
小学校|しょうがっこう
中学校|ちゅうがっこう
生徒|せいと
班|はん
グループ
分ける|わける
秋|あき
運動|うんどう
会|かい
団体|だんたい
競技|きょうぎ
修学|しゅうがく
旅行|りょこう
学年|がくねん
ニューヨーク
翌日|よくじつ
本人|ほんにん
観光|かんこう
バス
乗る|のる
黒い|くろい
髪|かみ
カメラ
あんまり
フットボール
ボーイスカウト
マーチング
バンド
程|ほど
どっち
大事|だいじ
さあ
杭|くい
打つ|うつ
諺|ことわざ
一員|いちいん
