面白い|おもしろい
先週|せんしゅう
日曜日|にちようび
客|きゃく
どんな
相槌|あいづち
合図|あいず
送る|おくる
詰まる|つまる
会う|あう
話す|はなす
電話|でんわ
土産|みやげ
貰う|もらう
すぐ
失礼|しつれい
横|よこ
仏壇|ぶつだん
何と|なんと
上げる|あげる
つまらない
風|かぜ
謙遜|けんそん
寿司|すし
注文|ちゅうもん
美味しい|おいしい
そうだ
召し上がる|めしあがる
口|くち
合う|あう
分|ふん
度|ど
遠慮|えんりょ
どんなに
目|め
いらっしゃる
デパート
買い物|かいもの
すると
御馳走|ごちそう
次に|つぎに
御礼|おれい
か月|かげつ
先日|せんじつ
御馳走様|ごちそうさま
しまう
知る|しる
来週|らいしゅう
時日|じじつ
クッキー
目上|めうえ
ちょっと
買う|かう
果物|くだもの
菓子|かし
