まるで
夫婦|ふうふ
彼女|かのじょ
泣く|なく
小さな|ちいさな
声|こえ
その他
恥知らず|はじしらず
幾ら|いくら
繋がる|つながる
出掛ける|でかける
陶器|とうき
古い|ふるい
かなり
値段|ねだん
張る|はる
比況
例示|れいじ
推量|すいりょう
判断|はんだん
屋上|おくじょう
車|くるま
心|こころ
火|ひ
熱い|あつい
氷|こおり
花火|はなび
塵｜ごみ
集める|あつめる
皆さん|みなさん
今日|きょう
遅刻|ちこく
牛乳|ぎゅうにゅう
悪い|わるい
臭い|くさい
誰|だれ
森|もり
元気|げんき
心配|しんぱい
雨|あめ
怠惰|たいだ

状態|じょうたい
変化|へんか
目的|もくてき
述べる|のべる
内容|ないよう
指示|しじ
依頼|いらい
早い|はやい
回復|かいふく
為さる|なさる
希望|きぼう
らしい
彼|かれ
男らしい|おとこらしい
実に|じつに
竹|たけ
割る|わる
竹を割った様
性格|せいかく
馬鹿|ばか
らしい
そんな
信じる|しんじる
少年|しょうねん
素直|すなお
歳|さい
以上|いじょう
言い訳|いいわけ
惨め|みじめ
ったら
敷く|しく
手|て
憎たらしい|にくたらしい
溶く|とく
鬼|おに
如く
形相|ぎょうそう
睨む|にらむ
若造
負ける|まける
娘|むすめ
蝶|ちょう
軽やか|かろやか
艶やか｜あでやか
舞う|まう
眠る|ねむる
安らか|やすらか
最期|さいご
迎える|むかえる
今回|こんかい
当社|とうしゃ
無関係|むかんけい
寒い|さむい
真冬｜まふゆ
戻る|もどる
相応しい|ふさわしい
毎晩|まいばん
祭る|まつる
祭り
賑わう|にぎわう
あたかも
実の|じつの
可愛がる|かわいがる
金融|きんゆう
破綻|はたん
全て|すべて
政府|せいふ
党|とう
無能|むのう
無策|むさく
生ずる|しょうずる
主張|しゅちょう
我が|わが
受け入れる|うけいれる
難い｜がたい
忙しい|いそがしい
新聞|しんぶん
読む|よむ
暇|ひま
清潔|せいけつ
癖|くせ
殆んど|ほとんど
病的|びょうてき
転ぶ|ころぶ
怪我|けが
大袈裟|おおげさ
騒ぐ|さわぐ
手紙|てがみ
本|ほん
何の|なんの
音沙汰|おとさた
食事|しょくじ
際|さい
昨日|きのう
山登り|やまのぼり
歩|ほ
悩む|なやむ
友人|ゆうじん
嬉しい|うれしい
涙|なみだ
苛める|いじめる
死ぬ|しぬ
辛い|つらい
経験|けいけん
過渡|かと
そんなに
上|うえ
星|ほし
今にも|いまにも
降る|ふる
感じる|かんじる
取れる|とれる
感じ取る
